a0,a1,a2,a3,a4,a5,a6,a7,a8,a9
63,63,63,63,63,35,61,51,51,60
52,61,60,60,61,35,35,61,35,60
34,35,60,60,52,60,60,60,61,34
34,35,60,13,13,13,11,60,60,34
35,35,51,61,61,61,61,61,61,60
34,61,61,13,13,11,11,61,52,34
34,61,52,52,60,35,61,60,60,34
60,60,60,60,60,61,60,60,60,143
34,60,60,60,60,60,60,52,52,34
34,52,35,35,61,112,61,61,52,34
