d0,d1,a0,a1,a2,a3,a4,a5,a6
0,0,3,1,1,3,6,6,4
0,0,1,1,1,1,1,1,1
0,0,3,1,1,3,2,1,1
0,0,1,2,1,1,1,1,1
0,0,0,0,1,1,1,5,1
