a0,a1,a2,a3,a4,a5,a6,a7,a8,a9,a10,a11,a12,a13,a14,a15,a16,a17,a18,a19
42,42,41,42,42,42,42,42,42,41,42,42,42,42,42,12,42,42,42,42
42,3,3,2,2,2,2,2,1,1,1,3,3,3,1,1,1,2,1,42
87,2,2,1,1,1,1,2,1,2,3,1,1,2,2,2,1,3,3,88
42,1,1,3,3,3,1,1,1,3,3,1,1,2,2,1,3,3,1,42
42,42,41,42,42,42,42,42,42,41,42,42,42,42,42,41,42,42,42,42
