a0,a1,a2,a3,a4,a5,a6,a7,a8,a9,a10,a11,a12,a13,a14
42,42,42,41,42,42,42,42,41,42,42,42,42,80,42
42,3,1,2,1,1,1,1,2,3,3,3,1,2,42
42,1,1,1,2,3,1,2,2,2,1,3,2,1,42
42,2,1,1,3,3,1,1,3,1,1,1,1,3,42
42,42,42,41,42,42,42,42,79,42,42,42,42,41,42
