a0,a1,a2,a3,a4,a5,a6,a7,a8,a9,a10,a11,a12,a13,a14
42,84,42,42,42,41,42,42,42,41,42,42,42,41,42
42,1,1,3,3,2,2,3,1,1,3,33,2,2,42
42,1,3,3,1,1,2,3,2,3,1,3,3,3,42
42,3,3,1,1,1,2,1,1,1,1,1,3,2,83
42,41,42,42,42,41,42,42,42,41,42,42,42,42,42
