a0,a1,a2,a3,a4,a5,a6,a7,a8,a9
118,119,118,105,118,118,119,118,119,118
118,119,118,119,118,118,119,118,119,118
118,119,118,119,118,118,119,118,119,118
18,18,118,118,119,119,118,118,18,18
9,9,9,9,7,10,9,9,10,10
10,18,7,7,18,18,9,9,18,9
10,10,7,9,10,9,9,9,9,106
9,9,9,9,9,9,10,9,7,7
7,18,9,9,18,18,10,10,18,7
9,9,7,9,7,7,9,9,7,9
